   WE                            ./textures/gamer.png 
NO      ./textures/winter.png



SO ./textures/fall.png

F   69, 222, 199

EA ./textures/cat_5.png

C 235, 198, 52

1111111111111111111111111111111111111111111111111111111111111111111111111111111111111111111111
1000000000000000000000000000000000000000000000000000000000000000000000000000000000000000000001
1000000000000000000000000000000000000000000000000000000000000000000000000000000000000000000001
100000000N000000000000000000000001111110000000000000000000000000000000000000000000000000000001
1000000000000000000000000000000010000001000000000000000000000000000000000000000000000000000001
1000000000000000000000000000000100000000111111111111111111111111000000000000000000000000000001
1000000000000000000000000000001000010000100000001000001000001000000000000000001111100000000001
1000001111100001010100000000000000000000100000000000001000001000000000000000000000000000000001
1000001000100000000000000000000000000000000000000000001000001000000000000000000000000000000001
1000001000100001000100000000000000000000000111110000000100000000000000000000000000000011000001
1000001000100000000000000000000000010000000000000000000000000000000000000000000000000000000001
1000001111000010101000000000000000000000000000000000000000000000000000000000000000100000000001
1000000000000000000000000000100000000000000000000000000000000000000000000000000000000000000001
1000000000000000000000000000000000000000000000000000000000000000010000000000000000000000000001
1000000000000000000000000000000000000000000000000000000000000000010000000000000000000000000001
1000000000000000000000000000000000000000010000000000000000000000010000000000000000000000000001
1000000000000000000000000000000000000000000000000000000000000111111100000000000000000000000001
1000000000000000000000000000000000000000000000000000000000000110100000000000000000000000000001
1000000000000000000000000000000000000000000000000000000000000110000000000000010000000000000001
1111111110000000000000000000000000000000000000000000000000000100000000000001110000000000000001
1001000010000000000000000000000000000000000000000000000000000000000000000000010000000000000001
1000001010000000000000011111111111111111110000000000000000000000000000000000010000000000000001
1001000010000000000000010000000000000000000000000000000000000000000011111111110000000000000001
1001111110000000000000010000000000000000000000000000000000000000000000000000000000000000000001
1000000000000000000000000000000000000000000000000000000000000000000000000000000000000000000001
1000000000000000000000000000000000000000000000000000000000000000000000000000000000000000000001
1000000000011111111000000000000000000000000000000000000000000000000000000000000000000000000001
1000000000000000000100000000000000000000000000010000000000000000000000000000000000000000000001
1000000000000000000001000000000000000000000000011100000000000000000000000000000000000000000001
1000000010000000000001000000000000000000000000010000000000000000000000000000000000000000000001
1000000010011111100010000000000000000000000000000000000000000000000000000000000000000000000001
1000000010100000100100000000000000000000000000000000000000000000000000000000000000000000000001
1000000010010000101000000000000000000000000000000000000000000000000000000000000000000000000001
1000000000000000000000000000000000000000000000011111111111111110000000000000000000000000000001
1000000111111111111100000000000000000000000011110000000000000000000000000000000000000000000001
1000000000000000000000000000000000000000000000010000000000000000000000000000000000000000000001
1000000000000000000000000000000000000000000000010000000000000000000000000000000000000000000001
1000000000000000000000000000000000000000000000000000000000000000000000000000000000000000000001
1000000000000000000000000000000000000000000000000000000000000000000000000000000000000000000001
1000000000000000000000000000000000000000000000000000000000000000000000000000000000000000000001
1111111111111111111111111111111111111111111111111111111111111111111111111111111111111111111111
