F 139,99,58
C 33,33,155

NO ./textures/png/cat02.png
SO ./textures/png/cat02.png
WE ./textures/png/cat02.png
EA ./textures/png/cat02.png

1111     1111
1001111111001
1000000000001
1100110110011
 11000N000111
  100111001
  110010011
   1100011
    11111