F 139,99,58
C 171,154,137

NO ./textures/png/cat02.png
SO ./textures/png/cat02.png
WE ./textures/png/cat02.png
EA ./textures/png/cat02.png

1111111111111111111
1001001001001001001
1001001001001001001
1001001001001001001
1001001000001001011
100000000S000000001
1010011111111000001
1111000000000001111
1000000101010000001
1111111111111111111
