F 139,99,58
C 171,154,137

NO ./textures/png/cat02.png
SO ./textures/png/cat02.png
WE ./textures/png/cat02.png
EA ./textures/png/cat02.png

1111
10N1
1111