F 139,99,58
C 171,154,137

NO ./textures/png/red.png
SO ./textures/png/green.png
WE ./textures/png/blue.png
EA ./textures/png/pink.png

1111111111111111111
1000000000000000001
1111000000000000001
1000000000000000001
100000000N000000011
1000000000000000001
1000000000000000001
1000000000000001111
1000000101010000001
1111111111111111111