F 139,99,58
C 171,154,137

NO ./textures/cat_2.png
SO ./textures/cat_1.png
WE ./textures/cat_6.png
EA ./textures/cat_3.png

11111111111111111111111111111
10000000000000000100000000001
10000000000000000100000000001
10000000000000000100000000001
11110000000000000000000000001
10000000000000000000000000001
10000000000000000000000000011
10000000000000N00000000000001
10000000000000000000000000001
11100000000000000000000000111
10000000000001010000000001111
10000000000010101000000000001
10000000000000000000000000001
10000000000000000000000000001
10000000000000000000000000001
11111111111111111111111111111