F 139,99,   1
C 171,154,137

NO ./textures/cat_1.png
SO ./textures/cat_2.png
WE ./textures/cat_3.png
EA ./textures/cat_4.png

  1111111111111111111
  0000000000000000001
111110000000000000011
  1000000000000000001
  1000000000000000001
  10000E0000000000001
  1000000000000000001
  1000000000000001111
  1000000101010000001
  1111111111111111111
